%%%%%%%%%%%%%%%
%    .        %
% ..   .%%.%% %
%   . .       %
%%% %% %%% %%.%
%o       .   P%
%%%%%%%%%%%%%%%