%%%%%%%%%%%%%%%
%    .        %
%  .   .%%.%% %
%o .  .       %
%%%.%% %%% %%.%
%            P%
%%%%%%%%%%%%%%%